R 960 540
NO ./textures/greystone.xpm
SO ./textures/purplestone.xpm
WE ./textures/redbrick.xpm
EA ./textures/bluestone.xpm

S  ./textures/barrel.xpm
F 220,100,0
C 225,30,0

      111111111111111111111
      100000000011000000001
      10110N000111000020001
      100100000020000000201111
111111111011020000111000020001
100022000011002000111011111111
11110111111111011110000010001
11110111111111011110101010001
11200020110101011110000010201
10000200020000000110000010201
10000020020000000010101010201
112200011101010101111011101011
11110111 111010101  101 101011
11111111 111111111  111 111111
